% Bitmap reprezentation ('.' - empty cell, '#' - filled cell)
% size 16 20

................
................
................
................
................
................
................
................
................
................
................
................
................
................
................
................
................
...#########....
.#..#...#....##.
#..#..###...#...
